##########################
#------------------------#
#-#----------------------#
#-#----------------------#
#------------------------#
#------------------------#
#------------------------#
#------------------------#
#------------------------#
#------------------------#
#------------------------#
#------------------------#
#------------------------#
#------------------------#
#------------------------#
##########################