##########################
#------------------------#
#-#-#----------------#-#-#
#------------------------#
#-#-#----------------#-#-#
#------------------------#
#-#------#-#-#-#-------#-#
#------------------------#
#------------------------#
#-#------#-#-#-#-------#-#
#------------------------#
#-#-#----------------#-#-#
#------------------------#
#-#-#----------------#-#-#
#------------------------#
##########################