##########################
#------------------------#
#------------------------#
#--####------------####--#
#--####------------####--#
#--####------------####--#
#------------------------#
#----------####----------#
#----------####----------#
#------------------------#
#--####------------####--#
#--####------------####--#
#--####------------####--#
#------------------------#
#------------------------#
##########################