################################################################
#--------------------------------------------------------------#
#--------------------------------------------------------------#
#--#######--------------------------------------------#######--#
#--#######--------------------------------------------#######--#
#--##------------------------------------------------------##--#
#--##------------------------------------------------------##--#
#---------##----------------------------------------##---------#
#---------##----------------------------------------##---------#
#--------------------------------------------------------------#
#--------------------------------------------------------------#
#--------------------------------------------------------------#
#--------------------------------------------------------------#
#--------------------------------------------------------------#
#--------------------------------------------------------------#
#--------------------------------------------------------------#
#--------------------------------------------------------------#
#--------------------------------------------------------------#
#--------------------------------------------------------------#
#--------------------------------------------------------------#
#--------------------------------------------------------------#
#---------##---------------------------------------##----------#
#---------##---------------------------------------##----------#
#--##------------------------------------------------------##--#
#--##------------------------------------------------------##--#
#--#######--------------------------------------------#######--#
#--#######--------------------------------------------#######--#
#--------------------------------------------------------------#
#--------------------------------------------------------------#
################################################################