######################################
#------------------------------------#
#------------------------------------#
#------------------------------------#
#---####----------------------####---#
#---####----------##----------####---#
#---####----------##----------####---#
#-----------------##-----------------#
#------------------------------------#
#------------------------------------#
#-----------###-------###------------#
#-----------###-------###------------#
#------------------------------------#
#------------------------------------#
#-----------------##-----------------#
#---####----------##----------####---#
#---####----------##----------####---#
#---####----------------------####---#
#------------------------------------#
#------------------------------------#
#------------------------------------#
######################################