##########################
#------------------------#
#------------------------#
#--####------------####--#
#--#------------------#--#
#--#------------------#--#
#------------------------#
#-----------##-----------#
#-----------##-----------#
#------------------------#
#--#------------------#--#
#--#------------------#--#
#--####------------####--#
#------------------------#
#------------------------#
##########################