##########################
#-----------##-----------#
#-----------##-----------#
#------------------------#
#---###------------###---#
#------------------------#
#------------------------#
###--------------------###
###--------------------###
#------------------------#
#------------------------#
#---###------------###---#
#------------------------#
#-----------##-----------#
#-----------##-----------#
##########################